{
	"layers": [
		{
            "tilemap" : "brinstarjunglebg",
			"width": 20,
			"height": 15,
			"depth": 0.5,
            "repeatX": true,
            "repeatY": true,
			"map": [
				1, 1, 1, 1, 1, 1, 1, 1, 3, 1, 1, 6, 1, 1, 1, 1, 5, 1, 1, 1,
				1, 1, 1, 1, 1, 1, 1, 1, 1, 2, 1, 1, 1, 1, 1, 1, 1, 1, 1, 1,
				1, 1, 1, 1, 7, 1, 1, 1, 1, 1, 1, 1, 2, 4, 1, 1, 1, 1, 1, 1,
				1, 1, 1, 2, 1, 1, 3, 1, 1, 1, 1, 1, 1, 1, 1, 1, 1, 1, 7, 1,
				1, 1, 1, 1, 1, 7, 1, 1, 1, 1, 1, 1, 1, 2, 2, 1, 8, 1, 1, 1,
				1, 1, 1, 5, 1, 1, 4, 1, 1, 1, 1, 1, 1, 1, 1, 1, 1, 1, 1, 1,
				4, 1, 1, 1, 1, 1, 1, 1, 1, 1, 3, 1, 1, 1, 1, 2, 1, 3, 1, 1,
				1, 1, 7, 1, 1, 1, 2, 1, 1, 1, 1, 1, 1, 1, 1, 1, 1, 1, 1, 1,
				1, 1, 1, 1, 1, 1, 1, 1, 8, 1, 1, 1, 1, 1, 1, 1, 1, 1, 1, 1,
				1, 1, 3, 1, 1, 1, 1, 1, 1, 1, 2, 1, 1, 1, 3, 1, 1, 1, 1, 1,
				1, 1, 1, 1, 1, 1, 1, 6, 1, 1, 1, 1, 1, 1, 1, 1, 2, 1, 1, 1,
				1, 1, 1, 1, 1, 3, 1, 1, 1, 1, 1, 1, 2, 1, 1, 7, 1, 1, 1, 1,
				1, 1, 2, 1, 1, 1, 1, 1, 1, 1, 1, 1, 1, 1, 4, 1, 1, 1, 1, 1,
				1, 1, 1, 1, 1, 1, 1, 1, 1, 1, 1, 1, 1, 1, 1, 1, 5, 1, 1, 1,
				1, 1, 1, 1, 1, 1, 1, 1, 1, 1, 1, 1, 1, 1, 1, 1, 1, 1, 1, 1
			]
		},
		{
            "tilemap" : "brinstarjungle",
			"width": 40,
			"height": 15,
			"depth": 1,
            "repeatX": false,
            "repeatY": false,
			"map": [
				3, 4, 1, 1, 1, 1, 1, 1, 1, 1, 1, 1, 1, 1, 1, 1, 1, 1, 1, 1,     1, 1, 1, 1, 1, 1, 1, 1, 1, 1, 1, 1, 1, 1, 1, 1, 1, 1, 1, 1,
				11, 12, 0, 0, 0, 0, 0, 0, 0, 0, 0, 0, 0, 1, 0, 0, 0, 0, 0, 0,     0, 0, 0, 0, 0, 0, 0, 0, 0, 0, 0, 0, 0, 0, 0, 0, 0, 0, 1, 1,
				19, 20, 0, 0, 0, 0, 0, 0, 0, 0, 0, 0, 0, 0, 0, 0, 0, 0, 0, 0,     0, 0, 0, 0, 0, 0, 0, 0, 0, 0, 0, 0, 0, 0, 0, 0, 0, 0, 0, 1,
				27, 28, 0, 0, 0, 0, 0, 0, 0, 0, 0, 0, 0, 0, 0, 0, 0, 0, 0, 0,     1, 1, 1, 1, 1, 1, 1, 1, 1, 1, 1, 1, 1, 1, 1, 1, 0, 0, 0, 1,
				0, 0, 0, 0, 0, 0, 0, 0, 0, 0, 0, 0, 0, 0, 0, 0, 0, 0, 0, 1,     1, 0, 0, 0, 0, 0, 0, 0, 0, 0, 0, 0, 0, 0, 0, 0, 0, 0, 0, 1,
				0, 0, 0, 0, 0, 0, 0, 0, 0, 0, 0, 0, 0, 0, 0, 0, 0, 0, 0, 0,     0, 0, 1, 0, 0, 0, 0, 0, 0, 0, 0, 0, 0, 0, 0, 0, 0, 0, 0, 1,
				1, 1, 0, 0, 0, 0, 0, 0, 0, 0, 0, 0, 0, 0, 0, 0, 0, 0, 0, 0,     1, 1, 1, 0, 0, 0, 0, 0, 0, 0, 0, 0, 0, 0, 0, 0, 0, 0, 0, 1,
				1, 1, 0, 0, 1, 1, 1, 0, 0, 0, 0, 0, 0, 1, 1, 1, 0, 0, 0, 0,     1, 1, 1, 0, 0, 0, 0, 0, 0, 0, 0, 1, 0, 0, 0, 1, 0, 0, 0, 1,
				1, 0, 0, 0, 0, 0, 1, 0, 0, 0, 0, 0, 0, 0, 0, 0, 0, 0, 0, 0,     0, 0, 0, 0, 0, 0, 0, 1, 0, 0, 0, 0, 0, 0, 0, 1, 0, 1, 1, 1,
				1, 0, 0, 0, 0, 0, 1, 0, 0, 0, 0, 0, 1, 0, 0, 0, 0, 0, 0, 0,     0, 0, 0, 0, 1, 0, 0, 0, 0, 0, 0, 0, 0, 0, 0, 1, 0, 0, 0, 1,
				1, 0, 0, 0, 0, 0, 1, 0, 0, 0, 0, 0, 0, 0, 0, 0, 0, 0, 0, 0,     0, 0, 0, 0, 0, 0, 0, 0, 0, 0, 0, 0, 0, 0, 0, 1, 0, 0, 0, 1,
				1, 0, 0, 0, 0, 0, 0, 0, 0, 0, 1, 0, 0, 0, 0, 0, 0, 0, 0, 0,     0, 0, 0, 0, 0, 0, 0, 0, 0, 0, 0, 0, 0, 0, 0, 1, 0, 0, 0, 1,
				1, 0, 0, 0, 0, 0, 0, 0, 0, 0, 0, 0, 0, 0, 0, 0, 0, 0, 0, 0,     0, 0, 0, 0, 0, 0, 0, 0, 0, 0, 0, 0, 0, 0, 0, 1, 0, 0, 0, 1,
				1, 0, 0, 0, 0, 0, 0, 0, 0, 0, 0, 0, 0, 0, 0, 0, 0, 0, 0, 0,     0, 0, 0, 0, 0, 0, 0, 0, 0, 0, 0, 0, 0, 0, 1, 1, 1, 0, 0, 1,
				1, 1, 1, 1, 1, 1, 1, 1, 1, 1, 1, 1, 1, 1, 1, 1, 1, 1, 1, 1,     1, 1, 1, 1, 1, 1, 1, 1, 1, 1, 1, 1, 1, 1, 1, 1, 1, 1, 1, 1
			]
		}
	],
	"entities": [
        {
			"class": "DTEntityRipper",
			"position": {
				"x": 11,
				"y": 7
			},
			"size": {
				"x": 1,
				"y": 0.5
			}
		},

		{
			"class": "DTEntityRipper",
			"position": {
				"x": 2,
				"y": 1
			},
			"size": {
				"x": 1,
				"y": 0.5
			}
		},
		{
			"class": "DTEntityRipper",
			"position": {
				"x": 5,
				"y": 5.2
			},
			"size": {
				"x": 1,
				"y": 0.5
			}
		},
                 {
                 "class": "DTEntityZoomer",
                 "position": {
                 "x": 14,
                 "y": 6
                 },
                 "size": {
                 "x": 1,
                 "y": 1
                 }
                 },
                 {
                 "class": "DTEntityZoomer",
                 "position": {
                 "x": 4,
                 "y": 6
                 },
                 "size": {
                 "x": 1,
                 "y": 1
                 }
                 },
        {
            "class": "DTEntitySidehopper",
            "position": {
                "x": 5,
                "y": 0
            }
        },
        {
			"class": "DTEntityDoor",
			"position": {
				"x": 0,
				"y": 4
			},
			"size": {
				"x": 0.1,
				"y": 2
			},
			"destinationRoom": "test2",
			"destinationPosition": {
			    "x": 17.8,
			    "y": 1.25
			}
		},
        {
			"class": "DTEntityDoor",
			"position": {
				"x": 38.8,
				"y": 6
			},
			"size": {
				"x": 0.2,
				"y": 2
			},
			"destinationRoom": "test2",
			"destinationPosition": {
			    "x": 1.5,
			    "y": 12.25
			}
		}
	]
}